6 7 7 7 7 7 7 7 7 7 7 17 14 14 14 14 14 6 7 7 7 7 7 7 7 7 7 7 7 17
12 3 2 2 2 2 2 2 2 2 2 12 14 14 14 14 14 12 2 2 2 2 2 2 2 2 2 2 2 12
12 2 2 2 2 2 2 2 2 2 2 12 14 14 14 14 14 12 2 2 2 2 2 2 2 2 2 2 2 12
9 10 10 10 10 10 10 10 17 2 2 12 14 14 14 14 14 12 2 2 6 10 10 10 10 10 10 10 10 16
15 15 15 15 15 15 15 15 12 2 2 12 14 14 14 14 14 12 2 2 12 15 15 15 15 15 15 15 15 15
15 15 15 15 15 15 15 15 12 2 2 12 14 14 14 14 14 12 2 2 12 15 15 6 7 7 17 15 15 15
15 15 15 15 15 15 15 15 12 2 2 12 14 6 7 7 7 17 2 2 6 7 7 17 2 2 6 7 7 17
15 15 15 15 6 7 7 17 12 2 2 12 14 12 2 2 2 2 2 2 2 2 2 2 2 2 2 2 2 12
6 7 7 7 17 2 2 6 17 2 2 12 14 12 2 2 2 2 2 2 2 2 2 2 2 2 2 2 2 12
12 2 2 2 2 2 2 2 2 2 2 12 14 9 10 10 10 17 2 2 6 10 10 10 10 10 10 10 10 16
12 2 2 2 2 2 2 2 2 2 2 12 14 14 14 14 14 12 2 2 12 15 15 15 15 15 15 15 15 15
12 2 2 6 10 10 10 10 17 2 2 12 14 14 14 14 14 12 2 2 12 15 15 6 7 7 17 15 15 15
12 2 2 12 15 15 15 15 12 2 2 12 14 6 7 7 7 17 2 2 6 7 7 17 2 2 6 7 7 17
12 2 2 12 6 7 7 17 12 2 2 12 14 12 2 2 2 2 2 2 2 2 2 2 2 2 2 2 2 12
12 2 2 12 12 2 2 12 12 2 2 12 14 12 2 2 2 2 2 2 2 2 2 2 2 2 2 2 2 12
12 2 2 12 12 2 2 12 12 2 2 12 14 9 10 10 10 17 2 2 6 10 10 10 10 10 10 10 10 16
12 2 2 9 16 2 2 12 12 2 2 12 14 14 14 14 14 12 2 2 12 15 15 15 15 15 15 15 15 15
12 2 2 2 2 2 2 12 12 2 2 9 10 10 10 10 10 16 2 2 9 10 10 10 10 10 10 10 10 17
12 2 2 2 2 2 2 12 12 2 2 2 2 2 2 2 2 2 2 2 2 2 2 2 2 2 2 2 2 12
9 10 10 10 10 10 10 16 12 2 2 2 2 2 2 2 2 2 2 2 2 2 2 2 2 2 2 2 2 12
15 15 15 15 15 15 15 15 9 10 10 10 10 10 10 10 10 10 10 10 10 10 10 10 10 10 10 10 10 16
